####################
#     ###    ###   #
###   # #    ###   #
# #   # ###        #
# #   #   #    #####
# #####   #        #
#         #        #
####      #        #
#  @               #
####################